****************************************************************
*                                                    *****     *
*     ***********      *              *  *            ***      *
*     *                *              *  *            ***      *
*     *                *           ***    ***        *****     *
*     *         ********         ***        ***                *
*     *                *        ***          ***               *
*     *                *        ***          ***               *
*                      *         ***        ***                *
*     *                *           *********                   *
*     ******     *******                                       *
*                                               *******    *****
*       *******                                 *              *
*                       ***************         *              *
*      ********                                 *              *
*****                   *                                      *
****************************************************************
